1 1 1 1 1 1 1 1 1 1 1 1 1 1 1 1 1 1 1 1 1 1 1 1 1 1 1 1
1 1 1 1 1 1 1 1 1 1 1 1 1 1 1 1 1 1 1 1 1 1 1 1 1 1 1 1
1 1 1 1 1 1 1 1 1 1 1 1 1 1 1 1 1 1 1 1 1 1 1 1 1 1 1 1
1 1 1 1 1 1 1 1 1 1 1 1 1 1 1 1 1 1 1 1 1 1 1 1 1 1 1 1
1 B B B B B B B B B B B B 1 1 B B B B B B B B B B B B 1
1 B 1 1 1 1 B 1 1 1 1 1 B 1 1 B 1 1 1 1 1 B 1 1 1 1 B 1
1 B 1 1 1 1 B 1 1 1 1 1 B 1 1 B 1 1 1 1 1 B 1 1 1 1 B 1
1 B 1 1 1 1 B 1 1 1 1 1 B 1 1 B 1 1 1 1 1 B 1 1 1 1 B 1
1 B B B B B B B B B B B B B B B B B B B B B B B B B B 1
1 B 1 1 1 1 B 1 1 B 1 1 1 1 1 1 1 1 B 1 1 B 1 1 1 1 B 1
1 B 1 1 1 1 B 1 1 B 1 1 1 1 1 1 1 1 B 1 1 B 1 1 1 1 B 1
1 B B B B B B 1 1 B B B B 1 1 B B B B 1 1 B B B B B B 1
1 1 1 1 1 1 B 1 1 1 1 1 B 1 1 B 1 1 1 1 1 B 1 1 1 1 1 1
1 1 1 1 1 1 B 1 1 1 1 1 B 1 1 B 1 1 1 1 1 B 1 1 1 1 1 1
1 1 1 1 1 1 B 1 1 0 0 0 0 0 C 0 0 0 0 1 1 B 1 1 1 1 1 1
1 1 1 1 1 1 B 1 1 0 1 1 1 1 1 1 1 1 0 1 1 B 1 1 1 1 1 1
1 1 1 1 1 1 B 1 1 0 1 1 1 1 1 1 1 1 0 1 1 B 1 1 1 1 1 1
0 0 0 0 0 0 B 0 0 0 1 1 1 1 1 1 1 1 0 0 0 B 0 0 0 0 0 0
1 1 1 1 1 1 B 1 1 0 1 1 1 1 1 1 1 1 0 1 1 B 1 1 1 1 1 1
1 1 1 1 1 1 B 1 1 0 1 1 1 1 1 1 1 1 0 1 1 B 1 1 1 1 1 1
1 1 1 1 1 1 B 1 1 0 0 0 0 0 0 0 0 0 0 1 1 B 1 1 1 1 1 1
1 1 1 1 1 1 B 1 1 0 1 1 1 1 1 1 1 1 0 1 1 B 1 1 1 1 1 1
1 1 1 1 1 1 B 1 1 0 1 1 1 1 1 1 1 1 0 1 1 B 1 1 1 1 1 1
1 B B B B B B B B B B B B 1 1 B B B B B B B B B B B B 1
1 B 1 1 1 1 B 1 1 1 1 1 B 1 1 B 1 1 1 1 1 B 1 1 1 1 B 1
1 B 1 1 1 1 B 1 1 1 1 1 B 1 1 B 1 1 1 1 1 B 1 1 1 1 B 1
1 B B B 1 1 B B B B B B B B A B B B B B B B 1 1 B B B 1
1 1 1 B 1 1 B 1 1 B 1 1 1 1 1 1 1 1 B 1 1 B 1 1 B 1 1 1
1 1 1 B 1 1 B 1 1 B 1 1 1 1 1 1 1 1 B 1 1 B 1 1 B 1 1 1
1 B B B B B B 1 1 B B B B 1 1 B B B B 1 1 B B B B B B 1
1 B 1 1 1 1 1 1 1 1 1 1 B 1 1 B 1 1 1 1 1 1 1 1 1 1 B 1
1 B 1 1 1 1 1 1 1 1 1 1 B 1 1 B 1 1 1 1 1 1 1 1 1 1 B 1
1 B B B B B B B B B B B B B B B B B B B B B B B B B B 1
1 1 1 1 1 1 1 1 1 1 1 1 1 1 1 1 1 1 1 1 1 1 1 1 1 1 1 1
1 1 1 1 1 1 1 1 1 1 1 1 1 1 1 1 1 1 1 1 1 1 1 1 1 1 1 1
1 1 1 1 1 1 1 1 1 1 1 1 1 1 1 1 1 1 1 1 1 1 1 1 1 1 1 1